-14 -14 -14 -14 -14 -14 -14 -9999 -13 -13 -13 -8 -8 -8 -8 -8 -8 -8 -8 -8 -8 -8 0 -8 
-14 0 0 0 0 0 0 0 0 0 0 0 0 0 -13 -8 -8 -8 -8 -8 -8 0 0 -8 
-9999 0 0 0 0 0 0 0 0 0 0 0 0 0 0 -13 0 0 -13 -13 -8 -8 0 -8 
-14 0 0 0 0 0 0 0 0 0 0 0 0 0 0 0 0 0 0 0 -8 -8 -8 -8 
-14 -14 0 0 -1 0 0 0 0 0 0 -14 0 0 0 0 0 0 0 0 0 0 0 -13 
-1 -1 -14 -1 -14 0 0 0 0 0 0 -14 -14 0 0 0 0 0 0 0 0 0 0 -9999 
-14 -1 -14 -1 0 0 0 0 0 0 0 0 -14 -1 0 0 0 0 0 0 0 0 0 -14 
-14 -1 -14 -1 0 0 0 -1 0 0 0 -10000 -11 -14 0 0 0 0 0 -15 -15 -1 -14 -15 
-14 -1 -1 0 0 0 -1 -1 0 0 0 0 0 -14 0 0 0 0 -15 -1 -15 -14 -15 -15 
-1 -1 -1 0 0 0 0 0 0 0 0 0 0 -1 0 0 0 -15 -15 -15 -15 -15 -1 -15 
-1 -14 -1 -14 0 0 0 0 0 0 0 0 0 -14 0 0 0 -15 -15 0 -10000 0 -15 -15 
-1 -1 -1 -1 0 0 0 0 0 0 -1 -14 0 0 0 0 0 0 -15 -15 0 0 -14 -15 
-1 -14 -14 -1 0 0 0 0 0 -1 -14 -1 0 0 0 0 0 0 0 -15 0 -15 -15 -15 
-1 -1 -14 -1 0 0 0 0 0 -1 0 0 0 0 0 0 0 0 0 0 0 -14 -15 -5 
-14 -1 -14 -14 0 0 0 0 0 0 0 0 0 0 0 0 0 0 0 0 -1 -15 -5 -5 
-14 -14 -1 0 0 0 0 0 0 0 0 0 0 0 0 0 0 0 0 0 -15 -5 -5 -5 
-14 -14 0 0 0 0 0 0 0 0 0 0 0 0 0 0 0 0 0 0 -5 -5 -5 -5 
-9999 0 0 0 0 0 0 -10 0 0 0 0 0 0 -10 0 0 0 0 -5 -5 -5 -5 -5 
-14 0 0 0 0 0 0 -10 -1 0 0 0 0 -1 -10 -10000 -11 0 -5 -5 -5 -5 -5 -5 
-1 -1 0 0 0 0 0 -10 -1 -1 0 0 0 -1 -10 -5 -5 -5 -5 -5 -5 -5 -5 -5 
-1 -1 -14 -14 -1 0 0 -10 -10 -10 -10 -10 -7 -10 -10 -5 -5 -5 -5 -5 -5 -5 -5 -5 
-1 -1 -1 -14 -1 -1 0 -10 -12 -12 -11 0 0 -1 -10 -5 -5 -5 -5 -5 -5 -5 -5 -5 
-1 -1 -1 -1 -14 -14 -14 -10 7 0 0 0 0 -14 -10 -5 -5 -5 -5 -5 -5 -5 -5 -5 
-1 -1 -1 -1 -1 -14 -14 -10 -10 -10 -10 -10 -10 -10 -10 -5 -5 -5 -5 -5 -5 -5 -5 -5 
