-5 -5 -5 -5 -5 -9 -8 -8 -8 -8 -8 -8 -8 0 0 0 0 0 0 -8 -8 -8 -8 -8 
-5 -5 -5 -5 -9 -9 -8 -8 0 0 0 0 0 0 0 -8 -8 0 0 -8 -8 -8 -8 -8 
-5 -5 -5 -9 -9 -8 -8 -8 0 -8 -8 -8 0 0 -8 -8 -8 0 0 -8 -8 -8 0 -8 
-5 -5 -9 -9 0 -8 -8 -8 -10000 -8 -8 -8 0 -8 -8 -8 -8 -8 0 -8 -8 0 0 -9999 
-5 -5 -9 0 0 0 -8 -8 -8 -8 -8 -8 0 0 -8 -8 -8 -8 0 -8 -8 -8 0 -8 
-5 -5 -9 0 -10 -10 -10 -10 -10 -10 0 0 0 -8 -8 -8 -8 0 0 0 -8 -8 0 -8 
-5 -5 -9 0 -10 -12 0 0 -13 -10 0 0 0 -8 -8 -8 0 0 0 0 0 0 0 -8 
-5 -9 -9 0 -10 4 0 0 0 -10 0 0 -8 -8 -8 -8 -8 0 0 0 0 -8 0 -8 
-9999 -9 -9 0 -10 0 0 0 0 -10 0 0 -8 -8 -8 -8 -8 -8 0 0 -8 -8 0 -8 
-5 -9 -9 0 -10 0 0 -10 -6 -10 0 0 -8 -8 -8 -8 -8 -8 -8 -8 -8 -8 0 0 
-5 -5 -9 -9 -10 -10 -10 -10 0 0 0 0 0 0 0 -8 -8 -8 -8 -8 -8 -8 -8 0 
-5 -5 -5 -9 0 0 0 0 0 0 0 0 0 0 0 0 0 -8 -8 -8 -8 0 0 0 
-5 -5 -5 -9 0 0 0 0 -12 -12 -12 -12 -12 0 0 0 0 0 0 -8 -8 0 -8 -8 
-5 -5 -9 -9 0 0 0 0 0 0 0 0 0 0 0 0 0 0 0 -8 -8 0 0 -8 
-5 -5 -9 0 0 0 0 0 0 0 0 0 0 0 0 0 0 0 -8 -8 -8 -8 0 -8 
-5 -5 -9 0 0 0 0 0 0 0 0 0 0 0 0 0 0 -8 -8 -8 -8 -8 0 -8 
-5 -9 -9 0 0 0 0 0 0 0 0 0 0 0 0 0 0 -8 -8 -8 -10000 -8 0 -8 
-9 -9 0 0 0 -2 -2 0 5 6 0 -2 -2 0 0 0 0 -8 -8 -8 0 -8 0 -8 
-9 0 0 0 0 -2 -2 0 -11 -11 0 -2 -2 0 0 0 0 -8 -8 -8 0 0 0 -8 
-9 0 0 0 0 -2 -2 0 0 0 0 -2 -2 0 0 0 0 -8 -8 -8 -8 -8 -8 -8 
-9 0 0 0 0 0 -2 -2 -2 -2 -2 -2 0 0 0 -13 -13 -13 -13 -8 -8 -8 -8 -8 
-9 -9 0 0 0 0 0 -2 -2 -2 -2 0 0 0 0 0 -13 -13 -13 -13 -8 -8 -8 -8 
-9 -9 -9 -9 0 0 0 0 0 0 0 0 0 0 -13 0 0 0 0 -13 -8 -8 -8 -8 
-9 -9 -9 -9 -9 -9 -13 -9999 -13 -9 -9 -9 -9 -9 -9 -13 -13 -13 -13 -13 -8 -8 -8 -8 
