-5 -5 -5 -5 -5 -5 -5 -5 -5 -5 -5 -5 -5 -5 -5 -5 -5 -5 -5 -5 -5 -5 -5 -5 
-9 -9 -9 -9 -9 -9 -9 -9 -9 -9 -9 -9 -9 -9 -9 -9 -9 -9 -9 -9 -9 -5 -5 -5 
-9 -9 -9 -9 -3 0 0 0 0 0 -2 -12 -12 -12 -12 -12 -12 -2 -2 -9 -9 -5 -5 -5 
-9 -9 -9 -3 -3 0 0 0 2 0 0 0 0 0 0 3 0 -13 -2 -9 -5 -5 -5 -5 
-9 -9 -3 -3 0 0 0 0 -11 0 0 0 0 0 0 0 0 0 -9 -9 -5 -5 -5 -5 
-9 -3 -3 -3 0 0 0 0 0 0 0 0 0 0 0 0 0 0 -9 -5 -5 -5 -5 -5 
-9 -3 -3 -3 0 0 0 0 0 0 0 0 0 0 0 0 0 -9 -9 -5 -5 -5 -5 -5 
-9 -3 -3 0 0 0 0 0 0 0 -9 -9 -9 -9 0 0 0 -9 -5 -5 -5 -5 -5 -5 
-9 0 0 0 0 0 0 -10 -10 -10 -6 -10 -10 -9 -9 -9 -9 -9 -9 -9 -9 -9 -9 -9999 
-9 0 0 0 0 0 0 -10 -8 0 0 -2 -10 0 0 0 0 -9 -5 -5 -5 -5 -5 -5 
-9 0 0 0 0 0 0 -10 -11 0 -10000 -2 -10 0 0 0 0 -9 -5 -5 -5 -5 -5 -5 
-9 0 0 0 0 0 0 -10 -10 -10 -10 -10 -10 0 0 0 0 -9 -5 -5 -5 -5 -5 -5 
-9 -9 0 0 0 0 0 0 0 0 0 0 0 0 0 0 0 -9 -9 -5 -5 -5 -5 -5 
-5 -9 -9 0 0 0 0 0 0 0 0 0 0 0 0 0 0 0 -9 -9 -5 -5 -5 -5 
-5 -5 -9 -9 0 0 0 0 0 0 0 0 0 0 0 0 0 0 0 -9 -5 -5 -5 -5 
-5 -5 -5 -9 -9 0 0 0 0 0 0 -8 -8 -8 -8 -8 0 0 0 -9 -9 -5 -5 -5 
-5 -5 -5 -5 -9 0 0 0 0 0 -8 -8 -5 -5 -5 -8 -8 0 0 0 -9 -9 -9 -9 
-5 -5 -5 -5 -9 0 0 0 0 0 -8 -5 -5 -10000 -5 -5 -8 -8 0 0 0 0 -9 -9 
-5 -5 -5 -5 -9 0 0 0 0 0 -8 -5 -5 -9 -5 -5 -5 -8 0 0 0 0 -9 -9 
-5 -5 -5 -5 -9 0 0 0 0 0 -8 -5 -5 -9 -5 -5 -5 -8 0 0 0 0 0 -9 
-5 -5 -5 -5 -9 0 0 0 0 0 -8 -8 -1 -9 -1 -8 -8 -8 0 0 0 0 0 -9 
-5 -5 -5 -5 -9 -9 0 0 0 0 0 0 0 -9 0 0 0 0 0 0 0 -8 -13 -9 
-5 -5 -5 -5 -5 -9 -9 -9 -9 -9 -9 1 -11 -9 0 0 0 0 0 0 0 -13 -13 -9 
-5 -5 -5 -5 -5 -9 -9 -9999 -9 -9 -9 -9 -9 -9 -9 -9 -9 -9 -9 -9 -9 -9 -9 -9 
